R 1920 1080
NO ./thomas.xpm
SO ./sky.xpm
WE ./femme.xpm
EA ./gold.xpm
S ./sky.xpm
F 220,100,0
C 225,30,0
1111111111111111111111111
1000000000000000000000001
1011000000000000000000001
1001000000000N00000000001
1111111100000000011100001
1000000000000000011101111
1111011111000000000000001
1111011111000001010010001
1100001101000000000010001
1000200000000000000010001
1000000000001101010010001
1100000111010101111000111
1111011111101011111010001
1111111111111111111111111
