R 1920 1080
NO ./ice.xpm
SO ./ice.xpm
WE ./ice.xpm
EA ./ice.xpm
CI ./mountain.xpm
FL ./sand.xpm
S ./sky.xpm
F 220,100,0
C 225,30,0
1111111111111111111111111111111111111111111111111
1000000000000000000000000000000000000000000000001
1011000000000000000000000000000000000000000000001
1001000000000N00000000000000000000000000000000001
1111000000000000000100000000000000000000000000001
1000000000000000000000000000000000000000000000001
1000000000000000000000000000000000000000000000001
1000000000000000011101110000000000000000000000001
1111000000000000000000000000000000000111100000001
1111011111000001010010000000000000000000100000001
1100001101000000000010000000000000000000100000001
1000200000000000000010000000000000000000111100001
1000000000001101010010000000000000000000000000001
1100000111010101111000110000000000000000000000001
1111011111101011111010000000000000000000000000001
1111111111111111111111111111111111111111111111111
