 R 1920 1080
 NO ./sky.xpm
 SO ./sky.xpm
 WE ./sky.xpm
 EA ./sky.xpm
 S ./sky.xpm
 F 220,100,0
 C 225,30,0
 1111111111111111111111111
 1000000000110000000000001
 1011000001110000001000001
 1001000000000000000000001
 1111111111110000011100001
 1000000000110000011101111
 1111011111111101110000001
 1111011111111101110101001
 1100000011010101110000001
 1000100000000000110000001
 100000000000N000110101001
 1100000111010101111101111
 1111011111101011011110101
 1111111111111111111111111
